#############################################################
#                                                           #
# # # # # # # # # # # # # # # # # # # # # # # # # # # # # # #
#                                                           #
# # # # # # # # # # # # # # # # # # # # # # # # # # # # # # #
#                                                           #
# # # # # # # # # # # # # # # # # # # # # # # # # # # # # # #
#                                                           #
# # # # # # # # # # # #     # # #     # # # # # # # # # # # #
#                                                           #
# # # # # # # # # # # #               # # # # # # # # # # # #
#                                                           #
# # # # # # # # # # # # #           # # # # # # # # # # # # #
#                                                           #
# # # # # # # # # # # # #           # # # # # # # # # # # # #
#                                                           #
# # # # # # # # # # # # #           # # # # # # # # # # # # #
#                                                           #
# # # # # # # # # # # # #           # # # # # # # # # # # # #
#                                                           #
# # # # # # # # # # # # #             # # # # # # # # # # # #
#                                                           #
# # # # # # # # # # # #     # # #     # # # # # # # # # # # #
#                                                           #
# # # # # # # # # # # # # # # # # # # # # # # # # # # # # # #
#                                                           #
# # # # # # # # # # # # # # # # # # # # # # # # # # # # # # #
#                                                           #
# # # # # # # # # # # # # # # # # # # # # # # # # # # # # # #
#    EEES                                                   #
#############################################################