#####################
#         #         #
# ### ### # ### ### #
# ### ### # ### ### #
#                   #
# ### # ##### # ### #
#     #  ###  #     #
##### ## ### ## #####
##### #       # #####
##### # ## ## # #####
        #   #        
##### # ##### # #####
##### #       # #####
#     # ##### #     #
# ###    ###    ### #
#   # ## ### ## #   #
### #     C     # ###
#     ## ### ##     #
# ###### ### ###### #
#                   #
#####################
