###################################
#                                 #
# # ##### ####### #### ## ### ### #
#   #                  ##         #
### # ### ### ### #  # ## ##### ###
#   #   # # # # # #  # ## #       #
### ##### ### ### #### ## ##### ###
#              C                  #
# ### ##### # #### # #### #### ## #
#           #      #              #
###################################
